___T__T___
__TT__TTTT
_________T
TTTT__T__T
___T__T___
___T_XT___
___T__T___
___T__T___
