_____T____
_____T____
___X_T____
_____T____
_____T____
_____T_X__
_____T____
__T__X____
