__________
__TTT_____
___T______
___T______
__________
__________
_X_______T
_____T____