__________
__TTT__X__
___T______
___T______
______X___
__________
_X_______T
_____T____